@ Waves

Ground*10
Ground*10
Flying*10

@ Map

0000011111111100000000000000000000000000000000000000
0000011111111100000000000000000000000000000000000000
0000011111111100000000000000000000000000000000000000
0000011111111100000000000000000000000000000000000000
0000011111111100000000000000000000000000000000000000
0000011111111100000000000000000000000000000000000000
0000011111111100000000000000000000000000000000000000
0000011111111100000000000000000000000000000000000000
0000011111111100000000000000000000000000000000000000
0000011111111100000000000000000000000000000000000000
0000011111111100000000000000000000000000000000000000
0000011111111100000000000000000000000000000000000000
0000011111111100000000000000000000000000000000000000
0000011111111100000000000000000000000000000000000000
0000011111111100000000000000000000000000000000000000
0000011111111100000000000000000000000000000000000000
0000011111111100000000000000000000000000000000000000
0000011111111100000000000000000000000000000000000000
0000011111111100000000000000000000000000000000000000
0000011111111100000000000000000000000000000000000000
0000011111111100000000000000000000000000000000000000
0000011111111100000000000000000000000000000000000000
0000011111111111111111111111111111111111100000000000
0000011111111111111111111111111111111111100000000000
0000011111111111111111111111111111111111100000000000
0000011111111111111111111111111111111111100000000000
0000011111111111111111111111111111111111100000000000
0000011111111111111111111111111111111111100000000000
0000000000000000000000000000000011111111100000000000
0000000000000000000000000000000011111111100000000000
0000000000000000000000000000000011111111100000000000
0000000000000000000000000000000011111111100000000000
0000000000000000000000000000000011111111100000000000
0000000000000000000000000000000011111111100000000000
0000000000000000000000000000000011111111100000000000
0000000000000000000000000000000011111111100000000000
0000000000000000000000000000000011111111100000000000
0000000000000000000000000000000011111111100000000000
0000000000000000000000000000000011111111100000000000
000000001110000000000000000000001111111110000000000
0000000100010000000000000000000011111111100000000000
0000001000001000000000000000000011111111100000000000
0000000001000000000000000000000011111111100000000000
0000000000000000000000000000000011111111100000000000
0000001000001000000000000000000011111111100000000000
0000000000000000000000000000000011111111100000000000
0000000000000000000000000000000011111111100000000000
0000000000000000000000000000000011111111100000000000
0000000000000000000000000000000011111111100000000000
0000000000000000000000000000000011111111100000000000
0000000000000000000000000000000011111111100000000000
0000000000000000000000000000000011111111100000000000

@ End