@ Map
0000011111100000000000000000000000000000000000000000
0000011111100000000000000000000000000000000000000000
0000011111100000000000000000000000000000000000000000
0000011111100000000000000000000000000000000000000000
0000011111100000000000000000000000000000000000000000
0000011111100000000000000000000000000000000000000000
0000011111100000000000000000000000000000000000000000
0000011111100000000000000000000000000000000000000000
0000011111100000000000000000000000000000000000000000
0000011111100000000000000000000000000000000000000000
0000011111100000000000000000000000000000000000000000
0000011111100000000000000000000000000000000000000000
0000011111100000000000000000000000000000000000000000
0000011111100000000000000000000000000000000000000000
0000011111100000000000000000000000000000000000000000
0000011111100000000000000000000000000000000000000000
0000011111100000000000000000000000000000000000000000
0000011111100000000000000000000000000000000000000000
0000011111100000000000000000000000000000000000000000
0000011111100000000000000000000000000000000000000000
0000011111100000000000000000000000000000000000000000
0000011111100000000000000000000000000000000000000000
0000011111111111111111111111111111111111100000000000
0000011111111111111111111111111111111111100000000000
0000011111111111111111111111111111111111100000000000
0000011111111111111111111111111111111111100000000000
0000011111111111111111111111111111111111100000000000
0000011111111111111111111111111111111111100000000000
0000000000000000000000000000000000011111100000000000
0000000000000000000000000000000000011111100000000000
0000000000000000000000000000000000011111100000000000
0000000000000000000000000000000000011111100000000000
0000000000000000000000000000000000011111100000000000
0000000000000000000000000000000000011111100000000000
0000000000000000000000000000000000011111100000000000
0000000000000000000000000000000000011111100000000000
0000000000000000000000000000000000011111100000000000
0000000000000000000000000000000000011111100000000000
0000000000000000000000000000000000011111100000000000
0000000000000000000000000000000000011111100000000000
0000000000000000000000000000000000011111100000000000
0000000000000000000000000000000000011111100000000000
0000000000000000000000000000000000011111100000000000
0000000000000000000000000000000000011111100000000000
0000000000000000000000000000000000011111100000000000
0000000000000000000000000000000000011111100000000000
0000000000000000000000000000000000011111100000000000
0000000000000000000000000000000000011111100000000000
0000000000000000000000000000000000011111100000000000
0000000000000000000000000000000000011111100000000000
0000000000000000000000000000000000011111100000000000
0000000000000000000000000000000000011111100000000000

@ Enemies
Flying
Flying
Ground

@ End