@ Waves

Type=Ground;Amount=10;Life=20
Type=Ground;Amount=20;Life=50
Type=Ground;Amount=30;Life=100

@ Queen

X=624
Y=32
LIFE=1000
DAMAGE=25
RANGE=32
ATTACKSPEED=1

@ EnemySpawn

X=176
Y=800

@ Tiles

0000111111111111110000000000000000000000000000000000
0000111111111111110000000000000000000000000000000000
0000111111111111110000000000000000000000000000000000
0000111111111111110000000000000000000000000000000000
0000111111111111110000000000000000000000000000000000
0000111111111111110000000000000000000000000000000000
0000111111111111110000000000000000000000000000000000
0000111111111111110000000000000000000000000000000000
0000111111111111110000000000000000000000000000000000
0000111111111111110000000000000000000000000000000000
0000111111111111110000000000000000000000000000000000
0000111111111111110000000000000000000000000000000000
0000111111111111110000000000000000000000000000000000
0000111111111111110000000000000000000000000000000000
0000111111111111110000000000000000000000000000000000
0000111111111111110000000000000000000000000000000000
0000111111111111110000000000000000000000000000000000
0000111111111111110000000000000000000000000000000000
0000111111111111110000000000000000000000000000000000
0000111111111111110000000000000000000000000000000000
0000111111111111110000000000000000000000000000000000
0000111111111111110000000000000000000000000000000000
0000111111111111111111111111111111111111111111110000
0000111111111111111111111111111111111111111111110000
0000111111111111111111111111111111111111111111110000
0000111111111111111111111111111111111111111111110000
0000111111111111111111111111111111111111111111110000
0000111111111111111111111111111111111111111111110000
0000000000000000000000000000000000111111111111110000
0000000000000000000000000000000000111111111111110000
0000000000000000000000000000000000111111111111110000
0000000000000000000000000000000000111111111111110000
0000000000000000000000000000000000111111111111110000
0000000000000000000000000000000000111111111111110000
0000000000000000000000000000000000111111111111110000
0000000000000000000000000000000000111111111111110000
0000000000000000000000000000000000111111111111110000
0000000000000000000000000000000000111111111111110000
0000000000000000000000000000000000111111111111110000
0000000000000000000000000000000000111111111111110000
0000000000000000000000000000000000111111111111110000
0000000000000000000000000000000000111111111111110000
0000000000000000000000000000000000111111111111110000
0000000000000000000000000000000000111111111111110000
0000000000000000000000000000000000111111111111110000
0000000000000000000000000000000000111111111111110000
0000000000000000000000000000000000111111111111110000
0000000000000000000000000000000000111111111111110000
0000000000000000000000000000000000111111111111110000
0000000000000000000000000000000000111111111111110000
0000000000000000000000000000000000111111111111110000
0000000000000000000000000000000000111111111111110000

@ End