@ Waves

Ground*10
Ground*10
Flying*10

@ Map

0000011111111100000000000000000000000000000000000000
0000011111111100000000000000000000000000000000000000
0000011111111100000000000000000000000000000000000000
0000011111111100000000000010000010000000000000000000
0000011111111100000000000000010000000000000000000000
0000011111111100000000000000000000000000000000000000
0000011111111100000000000001000100000000000000000000
0000011111111100000000000000111000000000000000000000
0000011111111100000000000000000000000000000000000000
0000011111111100000000000000000000000000000000000000
0000011111111100000000000000000000000000000000000000
0000011111111100000000000000000000000000000000000000
0000011111111100000000000000000000000000000000000000
0000011111111100000000000000000000000000000000000000
0000011111111100000000000000000000000000000000000000
0000011111111100000000000000000000000000000000000000
0000011111111100000000000000000000000000000000000000
0000011111111100000000000000000000000000000000000000
0000011111111100000000000000000000000000000000000000
0000011111111100000000000000000000000000000000000000
0000011111111100000000000000000000000000000000000000
0000011111111100000000000000000000000000000000000000
0000011111111111111111111111111111111111100000000000
0000011111111111111111111111111111111111100000000000
0000011111111111111111111111111111111111100000000000
0000011111111111111111111111111111111111100000000000
0000011111111111111111111111111111111111100000000000
0000011111111111111111111111111111111111100000000000
0000000000000000000000000000000011111111100000000000
0000000000000000000000000000000011111111100000000000
0000000000000000000000000000000011111111100000000000
0000000000000000000000000000000011111111100000000000
0000000000000000000000000000000011111111100000000000
0000000000000000000000000000000011111111100000000000
0000000000000000000000000000000011111111100000000000
0000000000000000000000000000000011111111100000000000
0000000000000000000000000000000011111111100000000000
0000000000000000000000000000000011111111100000000000
0000000000000000000000000000000011111111100000000000
0000000000000000000000000000000011111111100000000000
0000000000000000000000000000000011111111100000000000
0000000000000000000000000000000011111111100000000000
0000000000000000000000000000000011111111100000000000
0000000000000000000000000000000011111111100000000000
0000000000000000000000000000000011111111100000000000
0000000000000000000000000000000011111111100000000000
0000000000000000000000000000000011111111100000000000
0000000000000000000000000000000011111111100000000000
0000000000000000000000000000000011111111100000000000
0000000000000000000000000000000011111111100000000000
0000000000000000000000000000000011111111100000000000
0000000000000000000000000000000011111111100000000000

@ End