@ Waves

Type=Ground;Amount=30;Life=200
Type=Ground;Amount=50;Life=500
Type=Ground;Amount=100;Life=1000

@ Queen

X=528
Y=32
LIFE=1000
DAMAGE=25
RANGE=32
ATTACKSPEED=1

@ EnemySpawn

X=736
Y=768

@ Tiles
0000000000000000000000000000000000000000000000000000
0000111111111111111111111111111111111111111111110000
0000111111111111111111111111111111111111111111110000
0000111111111111111111111111111111111111111111110000
0000111111111111111111111111111111111111111111110000
0000111111111111111111111111111111111111111111110000
0000111111111111111111111111111111111111111111110000
0000111111111111111111111111111111111111111111110000
0000111111111111111111111111111111111111111111110000
0000111111111111111111111111111111111111111111110000
0000111111111111111111111111111111111111111111110000
0000111111111111111111111111111111111111111111110000
0000111111111111111111111111111111111111111111110000
0000100000000000000000000000000000000000000000000000
0000100000000000000000000010000000000000000000000000
0000100000000111111111100010000000000000000000000000
0000100000000100000000100010000000000000000000000000
0000100000000100000000100010000000000000000000000000
0000100000000100000000100010000000000000000000000000
0000100000000100000000100010000000000000000000000000
0000100000000100000000100010000000000000000000000000
0000100000000100000000100010000000000000000000000000
0000100000000100000000100010000000000000000000000000
0000100000011100000000111010000000111000000000000000
0000111111110011111111001111111111101000000000000000
0000000000000000000000000000000000001000000000000000
0000000000000000000000000000000000111000000000000000
0000000000000000000000000000000000100000000000000000
0000000000000000000000000000000000100000000000000000
0000000000000000000000000000000000100000000000000000
0000000000000000000000000000000000100000000000000000
0000000000000000000000000111111111111111111100000000
0000000000000000000000000111111111111111111100000000
0000000000000000000000000111111111111111111100000000
0000000000000000000000000111111111111111111100000000
0000000000000000000000000111111111111111111100000000
0000000000000000000000000111111111111111111100000000
0000000000000000000000000111111111111111111100000000
0000000000000000000000000111111111111111111100000000
0000000000000000000000000111111111111111111100000000
0000000000000000000000000111111111111111111100000000
0000000000000000000000000111111111111111111100000000
0000000000000000000000000000000000100000000000000000
0000000000000000000000000000000000100000000000000000
0000000000000000000000000000000000100000000000000000
0000000000000000000000000000000000100000000000000000
0000000000000000000000000000001111111110000000000000
0000000000000000000000000000001111111110000000000000
0000000000000000000000000000001111111110000000000000
0000000000000000000000000000001111111110000000000000
0000000000000000000000000000001111111110000000000000
0000000000000000000000000000000000000000000000000000

@ End