@ Waves

Ground*10
Ground*10
Flying*10

@ Queen

X=576
Y=32
LIFE=100
DAMAGE=10
RANGE=10
ATTACKSPEED=1

@ EnemySpawn

X=128
Y=800

@ Tiles

0000011111110000000000000000000000000000000000000000
0000011111110000000000000000000000000000000000000000
0000011111110000000000000000000000000000000000000000
0000011111110000000000000000000000000000000000000000
0000011111110000000000000000000000000000000000000000
0000011111110000000000000000000000000000000000000000
0000011111110000000000000000000000000000000000000000
0000011111110000000000000000000000000000000000000000
0000011111110000000000000000000000000000000000000000
0000011111110000000000000000000000000000000000000000
0000011111110000000000000000000000000000000000000000
0000011111110000000000000000000000000000000000000000
0000011111110000000000000000000000000000000000000000
0000011111110000000000000000000000000000000000000000
0000011111110000000000000000000000000000000000000000
0000011111110000000000000000000000000000000000000000
0000011111110000000000000000000000000000000000000000
0000011111110000000000000000000000000000000000000000
0000011111110000000000000000000000000000000000000000
0000011111110000000000000000000000000000000000000000
0000011111110000000000000000000000000000000000000000
0000011111110000000000000000000000000000000000000000
0000011111111111111111111111111111111111100000000000
0000011111111111111111111111111111111111100000000000
0000011111111111111111111111111111111111100000000000
0000011111111111111111111111111111111111100000000000
0000011111111111111111111111111111111111100000000000
0000011111111111111111111111111111111111100000000000
0000000000000000000000000000000000111111100000000000
0000000000000000000000000000000000111111100000000000
0000000000000000000000000000000000111111100000000000
0000000000000000000000000000000000111111100000000000
0000000000000000000000000000000000111111100000000000
0000000000000000000000000000000000111111100000000000
0000000000000000000000000000000000111111100000000000
0000000000000000000000000000000000111111100000000000
0000000000000000000000000000000000111111100000000000
0000000000000000000000000000000000111111100000000000
0000000000000000000000000000000000111111100000000000
0000000000000000000000000000000000111111100000000000
0000000000000000000000000000000000111111100000000000
0000000000000000000000000000000000111111100000000000
0000000000000000000000000000000000111111100000000000
0000000000000000000000000000000000111111100000000000
0000000000000000000000000000000000111111100000000000
0000000000000000000000000000000000111111100000000000
0000000000000000000000000000000000111111100000000000
0000000000000000000000000000000000111111100000000000
0000000000000000000000000000000000111111100000000000
0000000000000000000000000000000000111111100000000000
0000000000000000000000000000000000111111100000000000
0000000000000000000000000000000000111111100000000000

@ End