@ Waves

Ground*10
Ground*20
Ground*30

@ Queen

X=608
Y=32
LIFE=1000
DAMAGE=25
RANGE=32
ATTACKSPEED=1

@ EnemySpawn

X=160
Y=800

@ Tiles

0000111111111111000000000000000000000000000000000000
0000111111111111000000000000000000000000000000000000
0000111111111111000000000000000000000000000000000000
0000111111111111000000000000000000000000000000000000
0000111111111111000000000000000000000000000000000000
0000111111111111000000000000000000000000000000000000
0000111111111111000000000000000000000000000000000000
0000111111111111000000000000000000000000000000000000
0000111111111111000000000000000000000000000000000000
0000111111111111000000000000000000000000000000000000
0000111111111111000000000000000000000000000000000000
0000111111111111000000000000000000000000000000000000
0000111111111111000000000000000000000000000000000000
0000111111111111000000000000000000000000000000000000
0000111111111111000000000000000000000000000000000000
0000111111111111000000000000000000000000000000000000
0000111111111111000000000000000000000000000000000000
0000111111111111000000000000000000000000000000000000
0000111111111111000000000000000000000000000000000000
0000111111111111000000000000000000000000000000000000
0000111111111111000000000000000000000000000000000000
0000111111111111000000000000000000000000000000000000
0000111111111111111111111111111111111111111111000000
0000111111111111111111111111111111111111111111000000
0000111111111111111111111111111111111111111111000000
0000111111111111111111111111111111111111111111000000
0000111111111111111111111111111111111111111111000000
0000111111111111111111111111111111111111111111000000
0000000000000000000000000000000000111111111111000000
0000000000000000000000000000000000111111111111000000
0000000000000000000000000000000000111111111111000000
0000000000000000000000000000000000111111111111000000
0000000000000000000000000000000000111111111111000000
0000000000000000000000000000000000111111111111000000
0000000000000000000000000000000000111111111111000000
0000000000000000000000000000000000111111111111000000
0000000000000000000000000000000000111111111111000000
0000000000000000000000000000000000111111111111000000
0000000000000000000000000000000000111111111111000000
0000000000000000000000000000000000111111111111000000
0000000000000000000000000000000000111111111111000000
0000000000000000000000000000000000111111111111000000
0000000000000000000000000000000000111111111111000000
0000000000000000000000000000000000111111111111000000
0000000000000000000000000000000000111111111111000000
0000000000000000000000000000000000111111111111000000
0000000000000000000000000000000000111111111111000000
0000000000000000000000000000000000111111111111000000
0000000000000000000000000000000000111111111111000000
0000000000000000000000000000000000111111111111000000
0000000000000000000000000000000000111111111111000000
0000000000000000000000000000000000111111111111000000

@ End